bcr_patient_barcode	er_status_by_ihc	pr_status_by_ihc	her2_status_by_ihc
TCGA-3C-AAAU	Positive	Positive	Negative
TCGA-3C-AALI	Positive	Positive	Positive
TCGA-3C-AALJ	Positive	Positive	Indeterminate
TCGA-3C-AALK	Positive	Positive	Positive
TCGA-4H-AAAK	Positive	Positive	Equivocal
TCGA-5L-AAT0	Positive	Positive	Negative
TCGA-5L-AAT1	Positive	Positive	Equivocal
TCGA-5T-A9QA	Positive	Negative	Equivocal
TCGA-A1-A0SB	Positive	Negative	Negative
TCGA-A1-A0SD	Positive	Positive	Negative
TCGA-A1-A0SE	Positive	Positive	Negative
TCGA-A1-A0SF	Positive	Positive	Negative
TCGA-A1-A0SG	Positive	Positive	Negative
TCGA-A1-A0SH	Negative	Positive	Equivocal
TCGA-A1-A0SI	Positive	Positive	Negative
TCGA-A1-A0SJ	Positive	Positive	Equivocal
TCGA-A1-A0SK	Negative	Negative	Negative
TCGA-A1-A0SM	Positive	Negative	Positive
TCGA-A1-A0SN	Positive	Positive	Positive
TCGA-A1-A0SO	Negative	Negative	Equivocal
TCGA-A1-A0SP	Negative	Negative	Negative
TCGA-A1-A0SQ	Positive	Positive	Negative
TCGA-A2-A04N	Positive	Positive	NotEvaluated
TCGA-A2-A04P	Negative	Negative	NotEvaluated
TCGA-A2-A04Q	Negative	Negative	Equivocal
TCGA-A2-A04R	Positive	Positive	Equivocal
TCGA-A2-A04T	Negative	Negative	Equivocal
TCGA-A2-A04U	Negative	Negative	Negative
TCGA-A2-A04V	Positive	Positive	Equivocal
TCGA-A2-A04W	Negative	Negative	Positive
TCGA-A2-A04X	Positive	Positive	Positive
TCGA-A2-A04Y	Positive	Positive	Negative
TCGA-A2-A0CK	Positive	Positive	Negative
TCGA-A2-A0CL	Positive	Positive	Negative
TCGA-A2-A0CM	Negative	Negative	Negative
TCGA-A2-A0CO	Positive	Positive	Negative
TCGA-A2-A0CP	Positive	Positive	NotEvaluated
TCGA-A2-A0CQ	Positive	Positive	Equivocal
TCGA-A2-A0CR	Positive	Positive	Negative
TCGA-A2-A0CS	Positive	Positive	Equivocal
TCGA-A2-A0CT	Positive	Negative	Equivocal
TCGA-A2-A0CU	Positive	Positive	Equivocal
TCGA-A2-A0CV	Positive	Positive	Negative
TCGA-A2-A0CW	Positive	Positive	Equivocal
TCGA-A2-A0CX	Positive	Negative	Positive
TCGA-A2-A0CY	Positive	Positive	Negative
TCGA-A2-A0CZ	Positive	Positive	Negative
TCGA-A2-A0D0	Negative	Negative	Negative
TCGA-A2-A0D1	Negative	Negative	Positive
TCGA-A2-A0D2	Negative	Negative	Negative
TCGA-A2-A0D3	Positive	Positive	Negative
TCGA-A2-A0D4	Positive	Positive	Negative
TCGA-A2-A0EM	Positive	Positive	NotEvaluated
TCGA-A2-A0EN	Positive	Positive	Equivocal
TCGA-A2-A0EO	Positive	Positive	Negative
TCGA-A2-A0EP	Positive	Negative	Negative
TCGA-A2-A0EQ	Negative	Negative	Positive
TCGA-A2-A0ER	Positive	Positive	Equivocal
TCGA-A2-A0ES	Positive	Positive	Negative
TCGA-A2-A0ET	Positive	Positive	Equivocal
TCGA-A2-A0EU	Positive	Positive	Negative
TCGA-A2-A0EV	Positive	Positive	Negative
TCGA-A2-A0EW	Positive	Positive	Negative
TCGA-A2-A0EX	Positive	Positive	Negative
TCGA-A2-A0EY	Positive	Negative	Positive
TCGA-A2-A0ST	Negative	Negative	NotEvaluated
TCGA-A2-A0SU	Positive	Positive	Negative
TCGA-A2-A0SV	Positive	Positive	Equivocal
TCGA-A2-A0SW	Positive	Negative	NotEvaluated
TCGA-A2-A0SX	Negative	Negative	Negative
TCGA-A2-A0SY	Positive	Positive	NotEvaluated
TCGA-A2-A0T0	Negative	Negative	Negative
TCGA-A2-A0T1	Negative	Negative	Positive
TCGA-A2-A0T2	Negative	Negative	Negative
TCGA-A2-A0T3	Positive	Positive	Equivocal
TCGA-A2-A0T4	Positive	Positive	Equivocal
TCGA-A2-A0T5	Positive	Positive	Negative
TCGA-A2-A0T6	Positive	Positive	Negative
TCGA-A2-A0T7	Positive	Positive	Negative
TCGA-A2-A0YC	Positive	Positive	NotEvaluated
TCGA-A2-A0YD	Positive	Positive	NotEvaluated
TCGA-A2-A0YE	Negative	Negative	Negative
TCGA-A2-A0YF	Positive	Negative	Negative
TCGA-A2-A0YG	Positive	Positive	Positive
TCGA-A2-A0YH	Positive	Positive	Negative
TCGA-A2-A0YI	Positive	Positive	Negative
TCGA-A2-A0YJ	Positive	Negative	Negative
TCGA-A2-A0YK	Positive	Negative	Negative
TCGA-A2-A0YL	Positive	Positive	Negative
TCGA-A2-A0YM	Negative	Negative	NotEvaluated
TCGA-A2-A0YT	Positive	Negative	NotEvaluated
TCGA-A2-A1FV	Positive	Positive	Negative
TCGA-A2-A1FW	Positive	Negative	Negative
TCGA-A2-A1FX	Positive	Positive	NotEvaluated
TCGA-A2-A1FZ	Positive	Positive	Negative
TCGA-A2-A1G0	Positive	Positive	Equivocal
TCGA-A2-A1G1	Negative	Negative	Equivocal
TCGA-A2-A1G4	Positive	Positive	Negative
TCGA-A2-A1G6	Negative	Negative	Negative
TCGA-A2-A259	Positive	Positive	Negative
TCGA-A2-A25A	Positive	Positive	Equivocal
TCGA-A2-A25B	Positive	Positive	Equivocal
TCGA-A2-A25C	Positive	Positive	Negative
TCGA-A2-A25D	Positive	Negative	Negative
TCGA-A2-A25E	Positive	Positive	Equivocal
TCGA-A2-A25F	Negative	Positive	Negative
TCGA-A2-A3KC	Positive	Positive	Equivocal
TCGA-A2-A3KD	Positive	Positive	Negative
TCGA-A2-A3XS	Negative	Negative	NotEvaluated
TCGA-A2-A3XT	Negative	Negative	Negative
TCGA-A2-A3XU	Negative	Negative	NotEvaluated
TCGA-A2-A3XV	Positive	Negative	Equivocal
TCGA-A2-A3XW	Positive	Negative	Negative
TCGA-A2-A3XX	Negative	Negative	Negative
TCGA-A2-A3XY	Negative	Negative	Negative
TCGA-A2-A3XZ	Negative	Negative	Positive
TCGA-A2-A3Y0	Positive	Negative	Negative
TCGA-A2-A4RW	Positive	Positive	Negative
TCGA-A2-A4RX	Positive	Positive	Negative
TCGA-A2-A4RY	Positive	Positive	Negative
TCGA-A2-A4S0	Positive	Positive	Negative
TCGA-A2-A4S1	Positive	Negative	Negative
TCGA-A2-A4S2	Positive	Positive	Negative
TCGA-A2-A4S3	Positive	Positive	Negative
TCGA-A7-A0CD	Positive	Positive	Equivocal
TCGA-A7-A0CE	Negative	Negative	Equivocal
TCGA-A7-A0CG	Positive	Negative	Negative
TCGA-A7-A0CH	NotEvaluated	NotEvaluated	NotEvaluated
TCGA-A7-A0CJ	Positive	Positive	Negative
TCGA-A7-A0D9	Positive	Negative	Negative
TCGA-A7-A0DA	Negative	Negative	Negative
TCGA-A7-A0DB	Positive	Positive	Negative
TCGA-A7-A0DC	Positive	Negative	Negative
TCGA-A7-A13D	Negative	Positive	Equivocal
TCGA-A7-A13E	Positive	Negative	Equivocal
TCGA-A7-A13F	Positive	Positive	Equivocal
TCGA-A7-A13G	Positive	Positive	Negative
TCGA-A7-A13H	Positive	Positive	Equivocal
TCGA-A7-A26E	Positive	Positive	Negative
TCGA-A7-A26F	Negative	Negative	Equivocal
TCGA-A7-A26G	Negative	Negative	Negative
TCGA-A7-A26H	Positive	Negative	Equivocal
TCGA-A7-A26I	Negative	Negative	Equivocal
TCGA-A7-A26J	Positive	Positive	Negative
TCGA-A7-A2KD	Positive	Positive	Positive
TCGA-A7-A3IY	Positive	Positive	Negative
TCGA-A7-A3IZ	Positive	Negative	Equivocal
TCGA-A7-A3J0	Positive	Positive	Negative
TCGA-A7-A3J1	Positive	Positive	Negative
TCGA-A7-A3RF	Positive	Positive	Negative
TCGA-A7-A425	Positive	Positive	Indeterminate
TCGA-A7-A426	Positive	Positive	Negative
TCGA-A7-A4SA	Positive	Negative	Negative
TCGA-A7-A4SB	Positive	Positive	Negative
TCGA-A7-A4SC	Positive	Negative	Equivocal
TCGA-A7-A4SD	Negative	Negative	Equivocal
TCGA-A7-A4SE	Negative	Negative	Negative
TCGA-A7-A4SF	Positive	Negative	Positive
TCGA-A7-A56D	Positive	Positive	Negative
TCGA-A7-A5ZV	Negative	Negative	Equivocal
TCGA-A7-A5ZW	Positive	Positive	Negative
TCGA-A7-A5ZX	Positive	Positive	Negative
TCGA-A7-A6VV	Negative	Negative	Negative
TCGA-A7-A6VW	Negative	Negative	Negative
TCGA-A7-A6VX	Positive	Positive	Negative
TCGA-A7-A6VY	Negative	Negative	Negative
TCGA-A8-A06N	Positive	Negative	Negative
TCGA-A8-A06O	Positive	Positive	Negative
TCGA-A8-A06P	Positive	Positive	Negative
TCGA-A8-A06Q	Positive	Positive	Negative
TCGA-A8-A06R	Positive	Negative	Positive
TCGA-A8-A06T	Positive	Positive	Positive
TCGA-A8-A06U	Positive	Positive	Positive
TCGA-A8-A06X	Positive	Negative	Positive
TCGA-A8-A06Y	Positive	Positive	Negative
TCGA-A8-A06Z	Positive	Positive	Negative
TCGA-A8-A075	Positive	Positive	Positive
TCGA-A8-A076	Positive	Positive	Positive
TCGA-A8-A079	Positive	Positive	Negative
TCGA-A8-A07B	Positive	Positive	Positive
TCGA-A8-A07C	Negative	Negative	Negative
TCGA-A8-A07E	Positive	Positive	Negative
TCGA-A8-A07F	Positive	Positive	Negative
TCGA-A8-A07G	Positive	Positive	Negative
TCGA-A8-A07I	Positive	Negative	Positive
TCGA-A8-A07J	Positive	Positive	Negative
TCGA-A8-A07L	Positive	Positive	Negative
TCGA-A8-A07O	Negative	Negative	Negative
TCGA-A8-A07P	Positive	Positive	Positive
TCGA-A8-A07R	Negative	Negative	Positive
TCGA-A8-A07S	Positive	Negative	Negative
TCGA-A8-A07U	Negative	Positive	Negative
TCGA-A8-A07W	Positive	Positive	Negative
TCGA-A8-A07Z	Positive	Positive	Negative
TCGA-A8-A081	Positive	Positive	Negative
TCGA-A8-A082	Positive	Positive	Negative
TCGA-A8-A083	Positive	Positive	Negative
TCGA-A8-A084	Positive	Negative	Negative
TCGA-A8-A085	Positive	Positive	Negative
TCGA-A8-A086	Positive	Positive	Negative
TCGA-A8-A08A	Positive	Positive	Negative
TCGA-A8-A08B	Positive	Negative	Positive
TCGA-A8-A08C	Positive	Positive	Positive
TCGA-A8-A08F	Positive	Positive	Negative
TCGA-A8-A08G	Positive	Positive	Positive
TCGA-A8-A08H	Positive	Positive	Positive
TCGA-A8-A08I	Positive	Positive	Negative
TCGA-A8-A08J	Positive	Negative	Negative
TCGA-A8-A08L	Positive	Negative	Negative
TCGA-A8-A08O	Positive	Positive	Negative
TCGA-A8-A08P	Positive	Positive	Positive
TCGA-A8-A08R	Negative	Negative	Negative
TCGA-A8-A08S	Positive	Positive	Positive
TCGA-A8-A08T	Positive	Positive	Positive
TCGA-A8-A08X	Negative	Negative	Positive
TCGA-A8-A08Z	Positive	Positive	Negative
TCGA-A8-A090	Positive	Positive	Positive
TCGA-A8-A091	Positive	Negative	Negative
TCGA-A8-A092	Positive	Positive	Negative
TCGA-A8-A093	Positive	Positive	Negative
TCGA-A8-A094	Positive	Negative	Negative
TCGA-A8-A095	Positive	Positive	Negative
TCGA-A8-A096	Positive	Positive	Negative
TCGA-A8-A097	Positive	Positive	Positive
TCGA-A8-A099	Positive	Positive	Positive
TCGA-A8-A09A	Positive	Positive	Negative
TCGA-A8-A09B	Positive	Positive	Negative
TCGA-A8-A09C	Positive	Positive	Negative
TCGA-A8-A09D	Positive	Positive	Negative
TCGA-A8-A09E	Positive	Positive	Positive
TCGA-A8-A09G	Positive	Negative	Positive
TCGA-A8-A09I	Positive	Positive	Positive
TCGA-A8-A09K	Positive	Positive	Negative
TCGA-A8-A09M	Positive	Positive	Negative
TCGA-A8-A09N	Positive	Positive	Positive
TCGA-A8-A09Q	Positive	Positive	Negative
TCGA-A8-A09R	Positive	Positive	Negative
TCGA-A8-A09T	Positive	Positive	Negative
TCGA-A8-A09V	Positive	Positive	Negative
TCGA-A8-A09W	Positive	Positive	Negative
TCGA-A8-A09X	Negative	Negative	Negative
TCGA-A8-A09Z	Positive	Negative	Negative
TCGA-A8-A0A1	Positive	Positive	Negative
TCGA-A8-A0A2	Positive	Positive	Negative
TCGA-A8-A0A4	Positive	Positive	Negative
TCGA-A8-A0A6	Positive	Positive	Negative
TCGA-A8-A0A7	Negative	Negative	Positive
TCGA-A8-A0A9	Positive	Positive	Negative
TCGA-A8-A0AB	Positive	Positive	Positive
TCGA-A8-A0AD	Positive	Positive	Negative
TCGA-AC-A23C	Positive	Positive	Positive
TCGA-AC-A23E	Positive	Positive	NotEvaluated
TCGA-AC-A23G	Positive	Positive	Positive
TCGA-AC-A23H	Positive	Negative	Positive
TCGA-AC-A2B8	Positive	Positive	Negative
TCGA-AC-A2BK	Negative	Negative	Negative
TCGA-AC-A2BM	Positive	Positive	NotEvaluated
TCGA-AC-A2FB	Positive	Positive	Positive
TCGA-AC-A2FE	Positive	Positive	NotEvaluated
TCGA-AC-A2FF	Positive	Positive	NotEvaluated
TCGA-AC-A2FG	Positive	Negative	NotEvaluated
TCGA-AC-A2FK	Positive	Positive	NotEvaluated
TCGA-AC-A2FM	NotEvaluated	NotEvaluated	NotEvaluated
TCGA-AC-A2FO	Positive	Negative	Negative
TCGA-AC-A2QH	Negative	Negative	Negative
TCGA-AC-A2QI	Positive	Negative	Negative
TCGA-AC-A2QJ	Negative	Negative	Negative
TCGA-AC-A3BB	Positive	Positive	Negative
TCGA-AC-A3EH	Positive	Negative	Negative
TCGA-AC-A3HN	Positive	Positive	Negative
TCGA-AC-A3OD	Positive	Positive	Negative
TCGA-AC-A3QP	Positive	Positive	Equivocal
TCGA-AC-A3QQ	Positive	Positive	Positive
TCGA-AC-A3TM	Positive	Positive	Equivocal
TCGA-AC-A3TN	Positive	Positive	Positive
TCGA-AC-A3W5	Positive	Positive	NotEvaluated
TCGA-AC-A3W6	Positive	Positive	Negative
TCGA-AC-A3W7	Positive	Negative	Negative
TCGA-AC-A3YI	Positive	Positive	Positive
TCGA-AC-A3YJ	Positive	Positive	[Not Available]
TCGA-AC-A4ZE	Positive	Positive	Positive
TCGA-AC-A5EH	Positive	Negative	Negative
TCGA-AC-A5EI	Positive	Positive	Negative
TCGA-AC-A5XS	Positive	Positive	Negative
TCGA-AC-A5XU	Positive	Positive	Negative
TCGA-AC-A62V	Positive	Positive	NotEvaluated
TCGA-AC-A62X	Positive	Negative	NotEvaluated
TCGA-AC-A62Y	Positive	Positive	Negative
TCGA-AC-A6IV	Positive	Positive	Equivocal
TCGA-AC-A6IW	Negative	Negative	Negative
TCGA-AC-A6IX	Positive	Positive	NotEvaluated
TCGA-AC-A6NO	Positive	Positive	Negative
TCGA-AC-A7VB	Positive	Negative	NotEvaluated
TCGA-AC-A7VC	Negative	Negative	Negative
TCGA-AC-A8OP	Positive	Positive	Indeterminate
TCGA-AC-A8OQ	Negative	Negative	Indeterminate
TCGA-AC-A8OR	Positive	Positive	Negative
TCGA-AC-A8OS	Positive	Positive	Positive
TCGA-AN-A03X	Positive	Positive	Positive
TCGA-AN-A03Y	Positive	Positive	Negative
TCGA-AN-A041	Positive	Negative	Positive
TCGA-AN-A046	Positive	Positive	Negative
TCGA-AN-A049	Positive	Positive	Negative
TCGA-AN-A04A	Positive	Positive	Negative
TCGA-AN-A04C	Negative	Negative	Positive
TCGA-AN-A04D	Negative	Negative	Negative
TCGA-AN-A0AJ	Positive	Positive	Positive
TCGA-AN-A0AK	Positive	Negative	Positive
TCGA-AN-A0AL	Negative	Negative	Negative
TCGA-AN-A0AM	Positive	Negative	Negative
TCGA-AN-A0AR	Negative	Negative	Negative
TCGA-AN-A0AS	Positive	Negative	Negative
TCGA-AN-A0AT	Negative	Negative	Negative
TCGA-AN-A0FD	Positive	Positive	Positive
TCGA-AN-A0FF	Positive	Positive	Negative
TCGA-AN-A0FJ	Positive	Negative	Positive
TCGA-AN-A0FK	Positive	Positive	Positive
TCGA-AN-A0FL	Negative	Negative	Positive
TCGA-AN-A0FN	Positive	Positive	Positive
TCGA-AN-A0FS	Positive	Negative	Positive
TCGA-AN-A0FT	Positive	Positive	Positive
TCGA-AN-A0FV	Negative	Negative	Positive
TCGA-AN-A0FW	Positive	Indeterminate	Negative
TCGA-AN-A0FX	Negative	Negative	Positive
TCGA-AN-A0FY	Positive	Positive	Negative
TCGA-AN-A0FZ	Positive	Negative	Positive
TCGA-AN-A0G0	Negative	Negative	Negative
TCGA-AN-A0XL	Positive	Positive	Negative
TCGA-AN-A0XN	Negative	Positive	Negative
TCGA-AN-A0XO	Positive	Negative	Negative
TCGA-AN-A0XP	Positive	Positive	Positive
TCGA-AN-A0XR	Positive	Negative	Negative
TCGA-AN-A0XS	Negative	Positive	Negative
TCGA-AN-A0XT	Positive	Negative	Negative
TCGA-AN-A0XU	Negative	Negative	Negative
TCGA-AN-A0XV	Positive	Positive	Positive
TCGA-AN-A0XW	Positive	Positive	Positive
TCGA-AO-A03L	Positive	Positive	Positive
TCGA-AO-A03M	Positive	Positive	Negative
TCGA-AO-A03N	Positive	Positive	Negative
TCGA-AO-A03O	Positive	Positive	Negative
TCGA-AO-A03P	Positive	Positive	Negative
TCGA-AO-A03R	Positive	Positive	Negative
TCGA-AO-A03T	Positive	Positive	Negative
TCGA-AO-A03U	Negative	Negative	Negative
TCGA-AO-A03V	Positive	Positive	Negative
TCGA-AO-A0J2	Negative	Negative	Equivocal
TCGA-AO-A0J3	Positive	Positive	Equivocal
TCGA-AO-A0J4	Negative	Negative	Negative
TCGA-AO-A0J5	Positive	Negative	Equivocal
TCGA-AO-A0J6	Negative	Negative	Negative
TCGA-AO-A0J7	Positive	Positive	Negative
TCGA-AO-A0J8	Positive	Positive	Negative
TCGA-AO-A0J9	Positive	Positive	NotEvaluated
TCGA-AO-A0JA	Positive	Positive	Negative
TCGA-AO-A0JB	Positive	Positive	Negative
TCGA-AO-A0JC	Positive	Positive	Negative
TCGA-AO-A0JD	Positive	Positive	Negative
TCGA-AO-A0JE	Negative	Negative	Positive
TCGA-AO-A0JF	Positive	Positive	Negative
TCGA-AO-A0JG	Positive	Positive	Negative
TCGA-AO-A0JI	Positive	Negative	Negative
TCGA-AO-A0JJ	Positive	Positive	Negative
TCGA-AO-A0JL	Negative	Negative	Negative
TCGA-AO-A0JM	Positive	Positive	Positive
TCGA-AO-A124	Negative	Negative	Negative
TCGA-AO-A125	Positive	Positive	Negative
TCGA-AO-A126	Positive	Positive	Negative
TCGA-AO-A128	Negative	Negative	Negative
TCGA-AO-A129	Negative	Negative	Negative
TCGA-AO-A12A	Positive	Positive	Negative
TCGA-AO-A12B	Positive	Positive	Negative
TCGA-AO-A12C	Positive	Positive	Positive
TCGA-AO-A12D	Negative	Negative	Positive
TCGA-AO-A12E	Positive	Positive	Negative
TCGA-AO-A12F	Negative	Negative	Negative
TCGA-AO-A12G	Positive	Positive	Positive
TCGA-AO-A12H	Positive	Positive	Negative
TCGA-AO-A1KO	Positive	Positive	Negative
TCGA-AO-A1KP	Positive	Positive	Negative
TCGA-AO-A1KQ	Positive	Positive	Negative
TCGA-AO-A1KR	Negative	Negative	Negative
TCGA-AO-A1KS	Positive	Positive	Equivocal
TCGA-AO-A1KT	Positive	Positive	Equivocal
TCGA-AQ-A04H	Positive	Positive	Indeterminate
TCGA-AQ-A04J	Negative	Negative	Negative
TCGA-AQ-A04L	Positive	Negative	Positive
TCGA-AQ-A0Y5	Positive	Positive	Positive
TCGA-AQ-A1H2	Positive	Positive	Indeterminate
TCGA-AQ-A1H3	Positive	Positive	Negative
TCGA-AQ-A54N	Negative	Negative	Equivocal
TCGA-AQ-A54O	Positive	Positive	Negative
TCGA-AQ-A7U7	Positive	Positive	Negative
TCGA-AR-A0TP	Positive	Negative	Negative
TCGA-AR-A0TQ	Positive	Negative	Equivocal
TCGA-AR-A0TR	Positive	Positive	Equivocal
TCGA-AR-A0TS	Negative	Negative	Negative
TCGA-AR-A0TT	Positive	Negative	Negative
TCGA-AR-A0TU	Negative	Negative	Negative
TCGA-AR-A0TV	Positive	Positive	Equivocal
TCGA-AR-A0TW	Positive	Positive	Equivocal
TCGA-AR-A0TX	Positive	Positive	Positive
TCGA-AR-A0TY	Positive	Negative	Negative
TCGA-AR-A0TZ	Positive	Positive	Equivocal
TCGA-AR-A0U0	Negative	Negative	NotEvaluated
TCGA-AR-A0U1	Negative	Negative	Negative
TCGA-AR-A0U2	Positive	Positive	Negative
TCGA-AR-A0U3	Positive	Positive	Negative
TCGA-AR-A0U4	Negative	Negative	Negative
TCGA-AR-A1AH	Positive	Negative	Negative
TCGA-AR-A1AI	Negative	Negative	Equivocal
TCGA-AR-A1AJ	Positive	Negative	Negative
TCGA-AR-A1AK	Positive	Positive	Negative
TCGA-AR-A1AL	Positive	Positive	Negative
TCGA-AR-A1AM	Positive	Positive	Equivocal
TCGA-AR-A1AN	Positive	Positive	Negative
TCGA-AR-A1AO	Positive	Negative	Negative
TCGA-AR-A1AP	Positive	Positive	Equivocal
TCGA-AR-A1AQ	Negative	Negative	Equivocal
TCGA-AR-A1AR	Negative	Negative	Negative
TCGA-AR-A1AS	Positive	Positive	Negative
TCGA-AR-A1AT	Positive	Positive	Positive
TCGA-AR-A1AU	Positive	Positive	Equivocal
TCGA-AR-A1AV	Positive	Positive	Negative
TCGA-AR-A1AW	Positive	Positive	Equivocal
TCGA-AR-A1AX	Positive	Positive	Positive
TCGA-AR-A1AY	Negative	Negative	Negative
TCGA-AR-A24H	Positive	Positive	Negative
TCGA-AR-A24K	Positive	Positive	Equivocal
TCGA-AR-A24L	Positive	Positive	Equivocal
TCGA-AR-A24M	Positive	Positive	Negative
TCGA-AR-A24N	Positive	Positive	Equivocal
TCGA-AR-A24O	Positive	Positive	Negative
TCGA-AR-A24P	Positive	Positive	Equivocal
TCGA-AR-A24Q	Positive	Negative	Negative
TCGA-AR-A24R	Positive	Positive	Negative
TCGA-AR-A24S	Positive	Positive	Negative
TCGA-AR-A24T	Positive	Positive	Equivocal
TCGA-AR-A24U	Negative	Negative	Positive
TCGA-AR-A24V	Positive	Positive	Negative
TCGA-AR-A24W	Positive	Positive	Negative
TCGA-AR-A24X	Positive	Positive	Equivocal
TCGA-AR-A24Z	Positive	Positive	Negative
TCGA-AR-A250	Positive	Negative	Equivocal
TCGA-AR-A251	Positive	Negative	Equivocal
TCGA-AR-A252	Positive	Positive	Negative
TCGA-AR-A254	Positive	Positive	Positive
TCGA-AR-A255	Positive	Positive	Positive
TCGA-AR-A256	Negative	Negative	Negative
TCGA-AR-A2LE	Positive	Negative	NotEvaluated
TCGA-AR-A2LH	Negative	Negative	Equivocal
TCGA-AR-A2LJ	Positive	Positive	Positive
TCGA-AR-A2LK	Positive	Positive	Equivocal
TCGA-AR-A2LL	Positive	Positive	Equivocal
TCGA-AR-A2LM	Positive	Positive	NotEvaluated
TCGA-AR-A2LN	Positive	Positive	Negative
TCGA-AR-A2LO	Positive	Positive	Equivocal
TCGA-AR-A2LQ	Positive	Positive	Negative
TCGA-AR-A2LR	Negative	Negative	Negative
TCGA-AR-A5QM	Positive	Positive	Equivocal
TCGA-AR-A5QN	Positive	Positive	Positive
TCGA-AR-A5QP	Positive	Positive	Equivocal
TCGA-AR-A5QQ	Negative	Negative	Negative
TCGA-B6-A0I1	Negative	Negative	NotEvaluated
TCGA-B6-A0I2	NotEvaluated	NotEvaluated	NotEvaluated
TCGA-B6-A0I5	Positive	Positive	NotEvaluated
TCGA-B6-A0I6	Negative	Negative	NotEvaluated
TCGA-B6-A0I8	NotEvaluated	NotEvaluated	NotEvaluated
TCGA-B6-A0I9	Indeterminate	Positive	NotEvaluated
TCGA-B6-A0IA	Positive	Positive	NotEvaluated
TCGA-B6-A0IB	Positive	Positive	NotEvaluated
TCGA-B6-A0IC	Positive	Positive	NotEvaluated
TCGA-B6-A0IE	Negative	Negative	NotEvaluated
TCGA-B6-A0IG	Positive	Positive	NotEvaluated
TCGA-B6-A0IH	Positive	Positive	NotEvaluated
TCGA-B6-A0IJ	Positive	Positive	NotEvaluated
TCGA-B6-A0IK	Negative	Negative	NotEvaluated
TCGA-B6-A0IM	Positive	Positive	NotEvaluated
TCGA-B6-A0IN	Positive	Negative	NotEvaluated
TCGA-B6-A0IO	Positive	Indeterminate	NotEvaluated
TCGA-B6-A0IP	Positive	Positive	NotEvaluated
TCGA-B6-A0IQ	Negative	Negative	NotEvaluated
TCGA-B6-A0RE	Negative	Negative	NotEvaluated
TCGA-B6-A0RG	Negative	Negative	NotEvaluated
TCGA-B6-A0RH	Positive	Positive	NotEvaluated
TCGA-B6-A0RI	Positive	Positive	NotEvaluated
TCGA-B6-A0RL	Positive	Positive	NotEvaluated
TCGA-B6-A0RM	Positive	Positive	NotEvaluated
TCGA-B6-A0RN	Negative	Negative	NotEvaluated
TCGA-B6-A0RO	Positive	Positive	NotEvaluated
TCGA-B6-A0RP	Positive	Positive	NotEvaluated
TCGA-B6-A0RQ	Positive	Positive	NotEvaluated
TCGA-B6-A0RS	Negative	Negative	NotEvaluated
TCGA-B6-A0RT	Negative	Negative	NotEvaluated
TCGA-B6-A0RU	Negative	Negative	NotEvaluated
TCGA-B6-A0RV	Positive	Positive	NotEvaluated
TCGA-B6-A0WS	Positive	Positive	NotEvaluated
TCGA-B6-A0WT	Positive	Positive	NotEvaluated
TCGA-B6-A0WV	Positive	Positive	NotEvaluated
TCGA-B6-A0WW	Positive	Positive	NotEvaluated
TCGA-B6-A0WX	Negative	Negative	NotEvaluated
TCGA-B6-A0WY	Positive	Negative	NotEvaluated
TCGA-B6-A0WZ	Positive	Positive	NotEvaluated
TCGA-B6-A0X0	Positive	Positive	NotEvaluated
TCGA-B6-A0X1	Negative	Negative	NotEvaluated
TCGA-B6-A0X4	Positive	Positive	NotEvaluated
TCGA-B6-A0X5	Positive	Positive	NotEvaluated
TCGA-B6-A0X7	Positive	Positive	NotEvaluated
TCGA-B6-A1KC	Positive	Negative	Negative
TCGA-B6-A1KF	Negative	Negative	Equivocal
TCGA-B6-A1KI	Positive	Positive	Equivocal
TCGA-B6-A1KN	Negative	Negative	NotEvaluated
TCGA-B6-A2IU	Positive	Positive	NotEvaluated
TCGA-B6-A3ZX	Negative	Negative	Negative
TCGA-B6-A400	Negative	Negative	Negative
TCGA-B6-A401	Positive	Positive	Negative
TCGA-B6-A402	Negative	Negative	Negative
TCGA-B6-A408	Positive	Positive	Equivocal
TCGA-B6-A409	Negative	Negative	Equivocal
TCGA-B6-A40B	Positive	Positive	Negative
TCGA-B6-A40C	Positive	Positive	Negative
TCGA-BH-A0AU	Positive	Positive	Positive
TCGA-BH-A0AV	Negative	Negative	[Not Available]
TCGA-BH-A0AW	Positive	Negative	Positive
TCGA-BH-A0AY	Positive	Positive	Negative
TCGA-BH-A0AZ	Positive	Positive	Negative
TCGA-BH-A0B0	Positive	Positive	Negative
TCGA-BH-A0B1	Positive	Positive	Negative
TCGA-BH-A0B3	Negative	Negative	Negative
TCGA-BH-A0B4	Positive	Positive	Equivocal
TCGA-BH-A0B5	Positive	Positive	Negative
TCGA-BH-A0B6	Positive	Positive	Positive
TCGA-BH-A0B7	Positive	Positive	Positive
TCGA-BH-A0B8	Positive	Positive	Equivocal
TCGA-BH-A0B9	Negative	Negative	Negative
TCGA-BH-A0BA	Positive	Positive	Negative
TCGA-BH-A0BC	Positive	Positive	Negative
TCGA-BH-A0BD	Positive	Positive	Negative
TCGA-BH-A0BF	Positive	Positive	Negative
TCGA-BH-A0BG	Negative	Negative	Negative
TCGA-BH-A0BJ	Positive	Positive	Negative
TCGA-BH-A0BL	Negative	Negative	Negative
TCGA-BH-A0BM	Positive	Negative	Negative
TCGA-BH-A0BO	Positive	Positive	Negative
TCGA-BH-A0BP	Positive	Positive	Negative
TCGA-BH-A0BQ	Positive	Positive	Positive
TCGA-BH-A0BR	Positive	Positive	Negative
TCGA-BH-A0BS	Positive	Positive	[Not Available]
TCGA-BH-A0BT	Positive	Positive	Negative
TCGA-BH-A0BV	Positive	Positive	Negative
TCGA-BH-A0BW	Negative	Negative	[Not Available]
TCGA-BH-A0BZ	Positive	Positive	Negative
TCGA-BH-A0C0	Positive	Positive	Equivocal
TCGA-BH-A0C1	Positive	Positive	Negative
TCGA-BH-A0C3	Positive	Negative	Negative
TCGA-BH-A0C7	Positive	Negative	[Not Available]
TCGA-BH-A0DD	Positive	Positive	Positive
TCGA-BH-A0DE	Positive	Positive	Negative
TCGA-BH-A0DG	Positive	Negative	Negative
TCGA-BH-A0DH	Positive	Positive	Negative
TCGA-BH-A0DI	Positive	Positive	Negative
TCGA-BH-A0DK	Positive	Positive	Negative
TCGA-BH-A0DL	Positive	Negative	Negative
TCGA-BH-A0DO	Positive	Positive	Negative
TCGA-BH-A0DP	Positive	Positive	Negative
TCGA-BH-A0DQ	Positive	Positive	Negative
TCGA-BH-A0DS	Positive	Positive	Negative
TCGA-BH-A0DT	Positive	Positive	Negative
TCGA-BH-A0DV	Positive	Positive	Negative
TCGA-BH-A0DX	Positive	Positive	Negative
TCGA-BH-A0DZ	Positive	Positive	Positive
TCGA-BH-A0E0	Negative	Negative	Negative
TCGA-BH-A0E1	Positive	Positive	Equivocal
TCGA-BH-A0E2	Positive	Positive	Negative
TCGA-BH-A0E6	Negative	Negative	Equivocal
TCGA-BH-A0E7	Positive	Positive	Negative
TCGA-BH-A0E9	Positive	Positive	Negative
TCGA-BH-A0EA	Positive	Positive	Negative
TCGA-BH-A0EB	Positive	Positive	Equivocal
TCGA-BH-A0EE	Negative	Negative	Positive
TCGA-BH-A0EI	Positive	Positive	Negative
TCGA-BH-A0GY	Positive	Positive	Negative
TCGA-BH-A0GZ	Positive	Positive	Equivocal
TCGA-BH-A0H0	Positive	Positive	Negative
TCGA-BH-A0H3	Positive	Positive	[Not Available]
TCGA-BH-A0H5	Positive	Positive	[Not Available]
TCGA-BH-A0H6	Positive	Positive	Negative
TCGA-BH-A0H7	Positive	Positive	Negative
TCGA-BH-A0H9	Positive	Positive	Equivocal
TCGA-BH-A0HA	Positive	Positive	[Not Available]
TCGA-BH-A0HB	Positive	Positive	Equivocal
TCGA-BH-A0HF	Positive	Positive	Negative
TCGA-BH-A0HI	Positive	Positive	Negative
TCGA-BH-A0HK	Positive	Negative	Negative
TCGA-BH-A0HL	Positive	Positive	Equivocal
TCGA-BH-A0HN	Positive	Positive	Equivocal
TCGA-BH-A0HO	Positive	Positive	Negative
TCGA-BH-A0HP	Positive	Negative	Negative
TCGA-BH-A0HQ	Positive	Positive	Negative
TCGA-BH-A0HU	Positive	Positive	Negative
TCGA-BH-A0HW	Positive	Negative	Equivocal
TCGA-BH-A0HX	Positive	Positive	Negative
TCGA-BH-A0HY	Positive	Negative	Positive
TCGA-BH-A0RX	Negative	Negative	Negative
TCGA-BH-A0W3	Positive	Positive	Equivocal
TCGA-BH-A0W4	Positive	Positive	Negative
TCGA-BH-A0W5	Positive	Positive	Equivocal
TCGA-BH-A0W7	Positive	Positive	Negative
TCGA-BH-A0WA	Negative	Negative	Negative
TCGA-BH-A18F	Positive	Positive	Negative
TCGA-BH-A18G	Negative	Negative	Negative
TCGA-BH-A18H	Positive	Positive	Positive
TCGA-BH-A18I	Positive	Positive	Positive
TCGA-BH-A18J	Positive	Positive	Negative
TCGA-BH-A18K	Positive	Positive	Negative
TCGA-BH-A18L	Positive	Positive	Negative
TCGA-BH-A18M	Positive	Positive	Positive
TCGA-BH-A18N	Positive	Positive	Negative
TCGA-BH-A18P	Positive	Negative	Positive
TCGA-BH-A18Q	Negative	Negative	Positive
TCGA-BH-A18R	Indeterminate	Negative	Positive
TCGA-BH-A18S	Positive	Positive	Negative
TCGA-BH-A18T	Negative	Negative	Positive
TCGA-BH-A18U	Positive	Positive	Positive
TCGA-BH-A18V	Negative	Negative	Negative
TCGA-BH-A1EN	Negative	Negative	Positive
TCGA-BH-A1EO	Positive	Positive	Negative
TCGA-BH-A1ES	Positive	Positive	Negative
TCGA-BH-A1ET	Positive	Positive	Negative
TCGA-BH-A1EU	Positive	Positive	Negative
TCGA-BH-A1EV	Positive	Positive	Positive
TCGA-BH-A1EW	Negative	Negative	Negative
TCGA-BH-A1EX	Positive	Positive	Positive
TCGA-BH-A1EY	Positive	Positive	Negative
TCGA-BH-A1F0	Negative	Indeterminate	Negative
TCGA-BH-A1F2	Positive	Positive	Positive
TCGA-BH-A1F5	Positive	Positive	Negative
TCGA-BH-A1F6	Negative	Negative	Negative
TCGA-BH-A1F8	Positive	Positive	Positive
TCGA-BH-A1FB	Positive	Positive	Negative
TCGA-BH-A1FC	Negative	Negative	Negative
TCGA-BH-A1FD	Positive	Positive	Negative
TCGA-BH-A1FE	Positive	Positive	NotEvaluated
TCGA-BH-A1FG	Positive	Positive	Negative
TCGA-BH-A1FH	Positive	Negative	NotEvaluated
TCGA-BH-A1FJ	Negative	Positive	NotEvaluated
TCGA-BH-A1FL	Positive	Positive	NotEvaluated
TCGA-BH-A1FM	Positive	Negative	NotEvaluated
TCGA-BH-A1FN	Positive	Positive	NotEvaluated
TCGA-BH-A1FR	Positive	Positive	NotEvaluated
TCGA-BH-A1FU	Negative	Negative	NotEvaluated
TCGA-BH-A201	Positive	Positive	Negative
TCGA-BH-A202	Positive	Positive	Positive
TCGA-BH-A203	NotEvaluated	NotEvaluated	NotEvaluated
TCGA-BH-A204	NotEvaluated	NotEvaluated	NotEvaluated
TCGA-BH-A208	NotEvaluated	NotEvaluated	NotEvaluated
TCGA-BH-A209	Positive	Positive	NotEvaluated
TCGA-BH-A28O	Positive	Positive	Negative
TCGA-BH-A28Q	Positive	Positive	Negative
TCGA-BH-A2L8	Positive	Positive	Negative
TCGA-BH-A42T	Positive	Positive	Positive
TCGA-BH-A42U	Negative	Negative	Negative
TCGA-BH-A42V	Positive	Positive	Negative
TCGA-BH-A5IZ	Positive	Negative	Negative
TCGA-BH-A5J0	Positive	Positive	Negative
TCGA-BH-A6R8	Positive	Positive	NotEvaluated
TCGA-BH-A6R9	Negative	Positive	Negative
TCGA-BH-A8FY	Positive	Positive	Negative
TCGA-BH-A8FZ	Positive	Positive	Equivocal
TCGA-BH-A8G0	Positive	Positive	Negative
TCGA-BH-AB28	Positive	Positive	Negative
TCGA-C8-A12K	NotEvaluated	NotEvaluated	NotEvaluated
TCGA-C8-A12L	Negative	Negative	Equivocal
TCGA-C8-A12M	Positive	Negative	Negative
TCGA-C8-A12N	Positive	Positive	Negative
TCGA-C8-A12O	Positive	Positive	Negative
TCGA-C8-A12P	Negative	Negative	Positive
TCGA-C8-A12Q	Negative	Negative	Positive
TCGA-C8-A12T	Positive	Positive	Positive
TCGA-C8-A12U	Positive	Positive	Negative
TCGA-C8-A12V	Negative	Negative	Negative
TCGA-C8-A12W	Positive	Positive	Negative
TCGA-C8-A12X	Positive	Positive	Negative
TCGA-C8-A12Y	NotEvaluated	NotEvaluated	NotEvaluated
TCGA-C8-A12Z	Negative	Negative	Positive
TCGA-C8-A130	Positive	Positive	Equivocal
TCGA-C8-A131	Negative	Negative	Negative
TCGA-C8-A132	Positive	Positive	NotEvaluated
TCGA-C8-A133	Positive	Positive	NotEvaluated
TCGA-C8-A134	Negative	Negative	Equivocal
TCGA-C8-A135	Negative	Negative	Positive
TCGA-C8-A137	Negative	Negative	Positive
TCGA-C8-A138	Positive	Negative	Equivocal
TCGA-C8-A1HE	Positive	Positive	Equivocal
TCGA-C8-A1HF	Negative	Positive	Positive
TCGA-C8-A1HG	Positive	Positive	Negative
TCGA-C8-A1HI	Positive	Positive	Negative
TCGA-C8-A1HJ	Negative	Negative	Negative
TCGA-C8-A1HK	Negative	Negative	Positive
TCGA-C8-A1HL	Positive	Negative	Equivocal
TCGA-C8-A1HM	Positive	Positive	Negative
TCGA-C8-A1HN	Positive	Positive	Equivocal
TCGA-C8-A1HO	Positive	Positive	Negative
TCGA-C8-A26V	Positive	Positive	Negative
TCGA-C8-A26W	Positive	Positive	Equivocal
TCGA-C8-A26X	Negative	Negative	Negative
TCGA-C8-A26Y	Negative	Negative	Negative
TCGA-C8-A26Z	Positive	Positive	Negative
TCGA-C8-A273	Positive	Positive	Negative
TCGA-C8-A274	Positive	Positive	Negative
TCGA-C8-A275	NotEvaluated	NotEvaluated	NotEvaluated
TCGA-C8-A278	Negative	Negative	Positive
TCGA-C8-A27A	Positive	Positive	Negative
TCGA-C8-A27B	Negative	Negative	Negative
TCGA-C8-A3M7	Negative	Negative	Negative
TCGA-C8-A3M8	Positive	Positive	Positive
TCGA-C8-A8HP	Negative	Negative	Positive
TCGA-C8-A8HQ	Positive	Positive	Negative
TCGA-C8-A8HR	NotEvaluated	NotEvaluated	NotEvaluated
TCGA-C8-A9FZ	NotEvaluated	NotEvaluated	Negative
TCGA-D8-A13Y	Positive	Positive	Negative
TCGA-D8-A13Z	Negative	Negative	Negative
TCGA-D8-A140	Positive	Positive	Positive
TCGA-D8-A141	Positive	Positive	Negative
TCGA-D8-A142	Negative	Negative	Equivocal
TCGA-D8-A143	Negative	Negative	Negative
TCGA-D8-A145	Positive	Positive	Equivocal
TCGA-D8-A146	Positive	Positive	Negative
TCGA-D8-A147	Negative	Negative	Negative
TCGA-D8-A1J8	Positive	Positive	Negative
TCGA-D8-A1J9	Positive	Negative	Positive
TCGA-D8-A1JA	Negative	Negative	Positive
TCGA-D8-A1JB	Positive	Positive	Equivocal
TCGA-D8-A1JC	Positive	Positive	Negative
TCGA-D8-A1JD	Positive	Positive	Negative
TCGA-D8-A1JE	Positive	Positive	Negative
TCGA-D8-A1JF	Negative	Negative	Negative
TCGA-D8-A1JG	Negative	Negative	Equivocal
TCGA-D8-A1JH	Positive	Positive	Negative
TCGA-D8-A1JI	Positive	Positive	Negative
TCGA-D8-A1JJ	Positive	Positive	Negative
TCGA-D8-A1JK	Negative	Positive	Negative
TCGA-D8-A1JL	Negative	Negative	Negative
TCGA-D8-A1JM	Positive	Negative	Negative
TCGA-D8-A1JN	Positive	Positive	Indeterminate
TCGA-D8-A1JP	Positive	Positive	Negative
TCGA-D8-A1JS	Positive	Positive	Negative
TCGA-D8-A1JT	Positive	Positive	Equivocal
TCGA-D8-A1JU	Positive	Positive	Negative
TCGA-D8-A1X5	Positive	Positive	Positive
TCGA-D8-A1X6	Positive	Positive	Negative
TCGA-D8-A1X7	Positive	Positive	Negative
TCGA-D8-A1X8	Positive	Indeterminate	Negative
TCGA-D8-A1X9	Positive	Positive	Indeterminate
TCGA-D8-A1XA	Positive	Positive	Equivocal
TCGA-D8-A1XB	Positive	Positive	Negative
TCGA-D8-A1XC	Positive	Positive	Negative
TCGA-D8-A1XD	Positive	Positive	Negative
TCGA-D8-A1XF	Positive	Positive	Negative
TCGA-D8-A1XG	Positive	Negative	Negative
TCGA-D8-A1XJ	Positive	Positive	Positive
TCGA-D8-A1XK	Negative	Negative	Negative
TCGA-D8-A1XL	Positive	Positive	Equivocal
TCGA-D8-A1XM	Positive	Positive	Negative
TCGA-D8-A1XO	Positive	Positive	Negative
TCGA-D8-A1XQ	Negative	Negative	Negative
TCGA-D8-A1XR	Positive	Positive	Negative
TCGA-D8-A1XS	Positive	Positive	Positive
TCGA-D8-A1XT	Negative	Negative	Positive
TCGA-D8-A1XU	Positive	Positive	Negative
TCGA-D8-A1XV	Positive	Positive	Equivocal
TCGA-D8-A1XW	Negative	Positive	Negative
TCGA-D8-A1XY	Positive	Positive	Positive
TCGA-D8-A1XZ	Positive	Negative	Negative
TCGA-D8-A1Y0	Positive	Positive	Negative
TCGA-D8-A1Y1	Positive	Positive	Negative
TCGA-D8-A1Y2	Positive	Positive	Indeterminate
TCGA-D8-A1Y3	Positive	Positive	Indeterminate
TCGA-D8-A27E	Positive	Positive	Negative
TCGA-D8-A27F	Negative	Negative	Negative
TCGA-D8-A27G	Positive	Positive	Equivocal
TCGA-D8-A27H	Negative	Negative	Negative
TCGA-D8-A27I	Positive	Positive	Negative
TCGA-D8-A27K	Positive	Positive	Negative
TCGA-D8-A27L	Positive	Positive	Negative
TCGA-D8-A27M	Negative	Negative	Negative
TCGA-D8-A27N	Positive	Positive	Positive
TCGA-D8-A27P	Positive	Positive	Negative
TCGA-D8-A27R	Positive	Positive	Equivocal
TCGA-D8-A27T	Positive	Positive	Negative
TCGA-D8-A27V	Positive	Positive	Negative
TCGA-D8-A27W	Positive	Positive	Equivocal
TCGA-D8-A3Z5	Positive	Positive	Negative
TCGA-D8-A3Z6	Positive	Positive	Negative
TCGA-D8-A4Z1	Positive	Positive	Negative
TCGA-D8-A73U	Positive	Positive	Negative
TCGA-D8-A73W	Positive	Negative	Negative
TCGA-D8-A73X	Positive	Positive	Negative
TCGA-E2-A105	Positive	Positive	Equivocal
TCGA-E2-A106	Positive	Positive	Equivocal
TCGA-E2-A107	Positive	Negative	Equivocal
TCGA-E2-A108	Positive	Positive	Negative
TCGA-E2-A109	Positive	Negative	Equivocal
TCGA-E2-A10A	Positive	Positive	Positive
TCGA-E2-A10B	Positive	Positive	Equivocal
TCGA-E2-A10C	Positive	Positive	Negative
TCGA-E2-A10E	Positive	Positive	Equivocal
TCGA-E2-A10F	Positive	Positive	Equivocal
TCGA-E2-A14N	Negative	Negative	Negative
TCGA-E2-A14O	Positive	Positive	Equivocal
TCGA-E2-A14P	Negative	Negative	Positive
TCGA-E2-A14Q	Positive	Positive	Negative
TCGA-E2-A14R	Negative	Negative	Negative
TCGA-E2-A14S	Positive	Positive	Equivocal
TCGA-E2-A14T	Positive	Positive	Negative
TCGA-E2-A14U	Positive	Positive	Equivocal
TCGA-E2-A14V	Positive	Positive	Positive
TCGA-E2-A14W	Positive	Positive	NotEvaluated
TCGA-E2-A14X	Negative	Negative	Negative
TCGA-E2-A14Y	Positive	Positive	Equivocal
TCGA-E2-A14Z	Positive	Positive	Negative
TCGA-E2-A150	Negative	Negative	Negative
TCGA-E2-A152	Positive	Negative	Positive
TCGA-E2-A153	Positive	Positive	Negative
TCGA-E2-A154	Positive	Positive	Negative
TCGA-E2-A155	Positive	Negative	Negative
TCGA-E2-A156	Positive	Positive	Negative
TCGA-E2-A158	Negative	Negative	Negative
TCGA-E2-A159	Negative	Negative	NotEvaluated
TCGA-E2-A15A	Positive	Positive	Negative
TCGA-E2-A15C	Positive	Positive	Equivocal
TCGA-E2-A15D	Positive	Positive	Equivocal
TCGA-E2-A15E	Positive	Positive	NotEvaluated
TCGA-E2-A15F	Positive	Positive	Negative
TCGA-E2-A15G	Positive	Positive	Negative
TCGA-E2-A15H	Positive	Positive	Equivocal
TCGA-E2-A15I	Positive	Positive	Equivocal
TCGA-E2-A15J	Positive	Positive	Equivocal
TCGA-E2-A15K	Positive	Positive	Equivocal
TCGA-E2-A15L	Positive	Positive	Equivocal
TCGA-E2-A15M	Positive	Positive	Negative
TCGA-E2-A15O	Positive	Positive	Equivocal
TCGA-E2-A15P	Positive	Positive	Negative
TCGA-E2-A15R	Positive	Positive	Equivocal
TCGA-E2-A15S	Positive	Negative	Equivocal
TCGA-E2-A15T	Positive	Positive	Equivocal
TCGA-E2-A1AZ	Negative	Negative	Indeterminate
TCGA-E2-A1B0	Negative	Negative	Positive
TCGA-E2-A1B1	Positive	Positive	Equivocal
TCGA-E2-A1B4	Positive	Positive	Negative
TCGA-E2-A1B5	Positive	Positive	Negative
TCGA-E2-A1B6	Negative	Negative	Equivocal
TCGA-E2-A1BC	Positive	Positive	Negative
TCGA-E2-A1BD	Positive	Positive	Equivocal
TCGA-E2-A1IE	Positive	Positive	Equivocal
TCGA-E2-A1IF	Positive	Positive	Negative
TCGA-E2-A1IG	Positive	Positive	Negative
TCGA-E2-A1IH	Positive	Positive	Equivocal
TCGA-E2-A1II	Negative	Positive	Negative
TCGA-E2-A1IJ	Positive	Positive	Equivocal
TCGA-E2-A1IK	Positive	Positive	Negative
TCGA-E2-A1IL	Positive	Positive	Negative
TCGA-E2-A1IN	Positive	Positive	Negative
TCGA-E2-A1IO	Positive	Positive	Equivocal
TCGA-E2-A1IU	Positive	Positive	Negative
TCGA-E2-A1L6	Positive	Positive	Negative
TCGA-E2-A1L7	Negative	Negative	Negative
TCGA-E2-A1L8	Positive	Positive	Equivocal
TCGA-E2-A1L9	Positive	Positive	Negative
TCGA-E2-A1LA	Positive	Positive	Equivocal
TCGA-E2-A1LB	Negative	Negative	Positive
TCGA-E2-A1LE	Negative	Negative	Positive
TCGA-E2-A1LG	Negative	Negative	Equivocal
TCGA-E2-A1LH	Negative	Negative	Negative
TCGA-E2-A1LI	Negative	Negative	Equivocal
TCGA-E2-A1LK	Negative	Negative	Equivocal
TCGA-E2-A1LL	Negative	Negative	Negative
TCGA-E2-A1LS	Negative	Negative	Negative
TCGA-E2-A2P5	Positive	Positive	NotEvaluated
TCGA-E2-A2P6	Positive	Positive	NotEvaluated
TCGA-E2-A3DX	Positive	Positive	NotEvaluated
TCGA-E2-A56Z	Positive	Positive	Equivocal
TCGA-E2-A570	Positive	Positive	Equivocal
TCGA-E2-A572	Positive	Positive	Equivocal
TCGA-E2-A573	Negative	Negative	Equivocal
TCGA-E2-A574	Negative	Negative	Equivocal
TCGA-E2-A576	Positive	Positive	Equivocal
TCGA-E2-A9RU	Positive	Negative	Equivocal
TCGA-E9-A1N3	NotEvaluated	NotEvaluated	NotEvaluated
TCGA-E9-A1N4	Positive	Positive	Positive
TCGA-E9-A1N5	Positive	Positive	Positive
TCGA-E9-A1N6	Positive	Positive	Positive
TCGA-E9-A1N8	Negative	NotEvaluated	Negative
TCGA-E9-A1N9	Negative	Positive	Positive
TCGA-E9-A1NA	Positive	Positive	Positive
TCGA-E9-A1NC	Negative	Positive	Positive
TCGA-E9-A1ND	Negative	Negative	Positive
TCGA-E9-A1NE	Positive	Positive	Negative
TCGA-E9-A1NF	Positive	Positive	Negative
TCGA-E9-A1NG	Positive	Positive	Negative
TCGA-E9-A1NH	Positive	Positive	Negative
TCGA-E9-A1NI	Positive	Positive	Negative
TCGA-E9-A1QZ	NotEvaluated	NotEvaluated	NotEvaluated
TCGA-E9-A1R0	NotEvaluated	NotEvaluated	NotEvaluated
TCGA-E9-A1R2	Positive	Negative	Equivocal
TCGA-E9-A1R3	NotEvaluated	NotEvaluated	NotEvaluated
TCGA-E9-A1R4	NotEvaluated	NotEvaluated	NotEvaluated
TCGA-E9-A1R5	NotEvaluated	NotEvaluated	NotEvaluated
TCGA-E9-A1R6	NotEvaluated	NotEvaluated	NotEvaluated
TCGA-E9-A1R7	NotEvaluated	NotEvaluated	NotEvaluated
TCGA-E9-A1RA	NotEvaluated	NotEvaluated	NotEvaluated
TCGA-E9-A1RB	NotEvaluated	NotEvaluated	NotEvaluated
TCGA-E9-A1RC	NotEvaluated	NotEvaluated	NotEvaluated
TCGA-E9-A1RD	NotEvaluated	NotEvaluated	NotEvaluated
TCGA-E9-A1RE	NotEvaluated	NotEvaluated	NotEvaluated
TCGA-E9-A1RF	NotEvaluated	NotEvaluated	NotEvaluated
TCGA-E9-A1RG	NotEvaluated	NotEvaluated	NotEvaluated
TCGA-E9-A1RH	NotEvaluated	NotEvaluated	NotEvaluated
TCGA-E9-A1RI	NotEvaluated	NotEvaluated	NotEvaluated
TCGA-E9-A226	NotEvaluated	NotEvaluated	NotEvaluated
TCGA-E9-A227	Positive	Positive	Negative
TCGA-E9-A228	NotEvaluated	NotEvaluated	NotEvaluated
TCGA-E9-A229	NotEvaluated	NotEvaluated	NotEvaluated
TCGA-E9-A22A	Positive	Negative	Negative
TCGA-E9-A22B	Positive	Negative	Negative
TCGA-E9-A22D	Positive	Positive	Positive
TCGA-E9-A22E	Positive	Positive	Positive
TCGA-E9-A22G	Negative	Negative	Positive
TCGA-E9-A22H	Positive	Positive	Positive
TCGA-E9-A243	NotEvaluated	NotEvaluated	NotEvaluated
TCGA-E9-A244	NotEvaluated	NotEvaluated	NotEvaluated
TCGA-E9-A245	NotEvaluated	NotEvaluated	NotEvaluated
TCGA-E9-A247	NotEvaluated	NotEvaluated	NotEvaluated
TCGA-E9-A248	NotEvaluated	NotEvaluated	NotEvaluated
TCGA-E9-A249	NotEvaluated	NotEvaluated	NotEvaluated
TCGA-E9-A24A	NotEvaluated	NotEvaluated	NotEvaluated
TCGA-E9-A295	Positive	Positive	Positive
TCGA-E9-A2JS	NotEvaluated	NotEvaluated	NotEvaluated
TCGA-E9-A2JT	NotEvaluated	NotEvaluated	NotEvaluated
TCGA-E9-A3HO	NotEvaluated	NotEvaluated	NotEvaluated
TCGA-E9-A3Q9	Positive	Positive	Indeterminate
TCGA-E9-A3QA	NotEvaluated	NotEvaluated	NotEvaluated
TCGA-E9-A3X8	Positive	Positive	Positive
TCGA-E9-A54X	Positive	Positive	Negative
TCGA-E9-A54Y	Positive	Positive	Negative
TCGA-E9-A5FK	Positive	Positive	Negative
TCGA-E9-A5FL	Negative	Negative	Negative
TCGA-E9-A5UO	NotEvaluated	NotEvaluated	NotEvaluated
TCGA-E9-A5UP	NotEvaluated	NotEvaluated	NotEvaluated
TCGA-E9-A6HE	Positive	Positive	Negative
TCGA-EW-A1IW	Positive	Positive	Positive
TCGA-EW-A1IX	Positive	Positive	Negative
TCGA-EW-A1IY	Positive	Positive	Negative
TCGA-EW-A1IZ	Positive	Positive	Negative
TCGA-EW-A1J1	Positive	Positive	Negative
TCGA-EW-A1J2	Positive	Positive	Negative
TCGA-EW-A1J3	Positive	Positive	Positive
TCGA-EW-A1J5	Positive	Positive	Negative
TCGA-EW-A1J6	Positive	Positive	Negative
TCGA-EW-A1OV	Negative	Negative	Negative
TCGA-EW-A1OW	Negative	Negative	Negative
TCGA-EW-A1OX	Positive	Positive	Negative
TCGA-EW-A1OY	Positive	Positive	Negative
TCGA-EW-A1OZ	Positive	Negative	Equivocal
TCGA-EW-A1P0	Positive	Negative	Negative
TCGA-EW-A1P1	Negative	Negative	Equivocal
TCGA-EW-A1P3	Positive	Positive	Negative
TCGA-EW-A1P4	Negative	Negative	Negative
TCGA-EW-A1P5	Positive	Positive	Negative
TCGA-EW-A1P6	Positive	Positive	Negative
TCGA-EW-A1P7	Negative	Negative	Equivocal
TCGA-EW-A1P8	Negative	Negative	Negative
TCGA-EW-A1PA	Positive	Positive	Negative
TCGA-EW-A1PB	Negative	Negative	Negative
TCGA-EW-A1PC	Positive	Positive	Negative
TCGA-EW-A1PD	Positive	Positive	Equivocal
TCGA-EW-A1PE	Positive	Positive	Negative
TCGA-EW-A1PF	Positive	Positive	Negative
TCGA-EW-A1PG	Positive	Positive	Equivocal
TCGA-EW-A1PH	Negative	Negative	Negative
TCGA-EW-A2FR	Negative	Negative	Equivocal
TCGA-EW-A2FS	Positive	Negative	Negative
TCGA-EW-A2FV	Positive	Positive	Negative
TCGA-EW-A2FW	Positive	Positive	Negative
TCGA-EW-A3E8	Positive	Negative	Negative
TCGA-EW-A3U0	Negative	Negative	Negative
TCGA-EW-A423	Positive	Positive	Negative
TCGA-EW-A424	Positive	Positive	Positive
TCGA-EW-A6S9	Positive	Positive	Positive
TCGA-EW-A6SA	Positive	Negative	Negative
TCGA-EW-A6SB	Negative	Negative	Negative
TCGA-EW-A6SC	Positive	Positive	Negative
TCGA-EW-A6SD	Negative	Negative	NotEvaluated
TCGA-GI-A2C8	Positive	Positive	Negative
TCGA-GI-A2C9	Negative	Negative	Negative
TCGA-GM-A2D9	Positive	Positive	NotEvaluated
TCGA-GM-A2DA	Positive	Positive	Equivocal
TCGA-GM-A2DB	Negative	Negative	Negative
TCGA-GM-A2DC	Positive	Positive	NotEvaluated
TCGA-GM-A2DD	Negative	Negative	Equivocal
TCGA-GM-A2DF	Negative	Negative	Negative
TCGA-GM-A2DH	Negative	Negative	Negative
TCGA-GM-A2DI	Negative	Negative	NotEvaluated
TCGA-GM-A2DK	Positive	Negative	Negative
TCGA-GM-A2DL	Positive	Positive	Negative
TCGA-GM-A2DM	Positive	Positive	Negative
TCGA-GM-A2DN	Positive	Positive	Negative
TCGA-GM-A2DO	Positive	Positive	Negative
TCGA-GM-A3NW	Negative	Positive	Equivocal
TCGA-GM-A3NY	Positive	Positive	Negative
TCGA-GM-A3XG	Positive	Positive	Negative
TCGA-GM-A3XL	Negative	Negative	NotEvaluated
TCGA-GM-A3XN	Positive	Positive	Negative
TCGA-GM-A4E0	Positive	Positive	NotEvaluated
TCGA-GM-A5PV	Positive	Positive	NotEvaluated
TCGA-GM-A5PX	Positive	Positive	Negative
TCGA-HN-A2NL	Negative	Negative	Negative
TCGA-HN-A2OB	Positive	Positive	Negative
TCGA-JL-A3YW	Positive	Positive	Positive
TCGA-JL-A3YX	Positive	Positive	Positive
TCGA-LD-A66U	Positive	Positive	Negative
TCGA-LD-A74U	Positive	Negative	Negative
TCGA-LD-A7W5	Positive	Positive	Negative
TCGA-LD-A7W6	Positive	Positive	Negative
TCGA-LD-A9QF	Negative	Negative	Positive
TCGA-LL-A440	Positive	Positive	Equivocal
TCGA-LL-A441	Negative	Negative	Negative
TCGA-LL-A442	Positive	Positive	Equivocal
TCGA-LL-A50Y	Positive	Positive	Equivocal
TCGA-LL-A5YL	Positive	Negative	Positive
TCGA-LL-A5YM	Positive	Positive	Equivocal
TCGA-LL-A5YN	Positive	Positive	Equivocal
TCGA-LL-A5YO	Negative	Negative	Negative
TCGA-LL-A5YP	Positive	Negative	Negative
TCGA-LL-A6FP	Positive	Positive	Equivocal
TCGA-LL-A6FQ	Positive	Positive	Negative
TCGA-LL-A6FR	Negative	Positive	Equivocal
TCGA-LL-A73Y	Negative	Negative	Negative
TCGA-LL-A73Z	Positive	Positive	Equivocal
TCGA-LL-A740	Negative	Negative	Equivocal
TCGA-LL-A7SZ	Positive	Positive	Negative
TCGA-LL-A7T0	Positive	Positive	Positive
TCGA-LL-A8F5	Positive	Negative	Negative
TCGA-LL-A9Q3	Positive	Positive	Positive
TCGA-LQ-A4E4	Positive	Positive	NotEvaluated
TCGA-MS-A51U	Positive	Positive	Negative
TCGA-OK-A5Q2	Positive	Positive	Negative
TCGA-OL-A5D6	Negative	Negative	NotEvaluated
TCGA-OL-A5D7	Negative	Negative	NotEvaluated
TCGA-OL-A5D8	Positive	Positive	NotEvaluated
TCGA-OL-A5DA	Positive	Positive	NotEvaluated
TCGA-OL-A5RU	Positive	Positive	NotEvaluated
TCGA-OL-A5RV	Positive	Positive	NotEvaluated
TCGA-OL-A5RW	Negative	Negative	NotEvaluated
TCGA-OL-A5RX	Positive	Positive	NotEvaluated
TCGA-OL-A5RY	Positive	Negative	NotEvaluated
TCGA-OL-A5RZ	Positive	Negative	NotEvaluated
TCGA-OL-A5S0	Positive	Negative	NotEvaluated
TCGA-OL-A66H	Positive	Positive	NotEvaluated
TCGA-OL-A66I	Negative	Negative	NotEvaluated
TCGA-OL-A66J	Positive	Positive	NotEvaluated
TCGA-OL-A66K	Positive	Positive	Equivocal
TCGA-OL-A66L	Positive	Positive	NotEvaluated
TCGA-OL-A66N	Positive	Negative	NotEvaluated
TCGA-OL-A66O	Positive	Positive	NotEvaluated
TCGA-OL-A66P	Negative	Negative	NotEvaluated
TCGA-OL-A6VO	Negative	Negative	Negative
TCGA-OL-A6VQ	Positive	Positive	NotEvaluated
TCGA-OL-A6VR	Positive	Positive	Negative
TCGA-OL-A97C	Negative	Negative	NotEvaluated
TCGA-PE-A5DC	Positive	Positive	Positive
TCGA-PE-A5DD	Positive	Negative	Positive
TCGA-PE-A5DE	Positive	Positive	Negative
TCGA-PL-A8LV	NotEvaluated	NotEvaluated	NotEvaluated
TCGA-PL-A8LX	NotEvaluated	NotEvaluated	NotEvaluated
TCGA-PL-A8LY	NotEvaluated	NotEvaluated	NotEvaluated
TCGA-PL-A8LZ	NotEvaluated	NotEvaluated	NotEvaluated
TCGA-S3-A6ZF	Positive	Positive	Equivocal
TCGA-S3-A6ZG	Positive	Positive	Negative
TCGA-S3-A6ZH	Positive	Positive	Equivocal
TCGA-S3-AA0Z	Positive	Positive	Equivocal
TCGA-S3-AA10	Negative	Negative	Negative
TCGA-S3-AA11	Positive	Positive	Equivocal
TCGA-S3-AA12	Positive	Negative	Negative
TCGA-S3-AA14	Positive	Positive	Positive
TCGA-S3-AA15	Negative	Negative	Negative
TCGA-S3-AA17	Positive	Positive	Equivocal
TCGA-UL-AAZ6	Positive	Positive	Positive
TCGA-UU-A93S	Negative	Negative	Positive
TCGA-V7-A7HQ	Positive	Positive	NotEvaluated
TCGA-W8-A86G	Positive	Positive	Negative
TCGA-WT-AB41	Positive	Positive	NotEvaluated
TCGA-WT-AB44	Positive	Positive	Negative
TCGA-XX-A899	Positive	Positive	Negative
TCGA-XX-A89A	Positive	Positive	Negative
TCGA-Z7-A8R5	Positive	Positive	Negative
TCGA-Z7-A8R6	Positive	Positive	Negative